0,r,r,0,0,0,0,r,r,0,
0,0,0,0,0,0,0,i,r,0,
0,0,0,0,0,g,0,0,r,0,
0,0,0,0,0,0,0,0,r,0,
r,b,r,r,0,r,r,b,r,0,
0,0,0,0,0,r,r,0,0,0,
0,0,0,0,0,0,0,0,0,0,
0,0,0,0,0,0,0,0,0,0,
r,0,0,0,g,0,0,0,0,0,
r,0,0,0,0,0,0,0,0,0,
