0,0,0,0,0,0,0,0,0,0,
0,0,g,0,0,0,b,0,0,0,
0,0,0,0,0,0,b,0,0,0,
0,0,0,0,0,0,b,0,0,0,
0,0,0,0,0,0,b,0,0,0,
0,0,0,0,0,0,0,0,0,0,
0,0,0,0,i,0,0,0,0,0,
0,0,0,0,0,0,0,0,0,0,
0,0,0,0,0,0,0,0,0,0,
0,0,0,0,0,0,0,0,0,0,
